NO ./textures/wall_north.xpm
SO ./textures/wall_south.xpm
WE ./textures/wall_west.xpm
EA ./textures/wall_east.xpm

F 91,76,51
C 22,219,25


111111111
1000000001
1000000001                
1000000001
1000000001
1000000001            
100E000001
1000000001               
1000000001     
1000100001               
1001 10001                     
1001 11111          
1111 11111     